11111111111111
1P000000000001
10000000000001
10000000000C01
10000000000001
11100000000E01
1E100000000001
11111111111111