11111111111111
10000000000001
1P000000000001
10000000000C01
1111110E000001
10000100000001
10000100000001
11111111111111