11111111111111
10000000000001
1000P000000001
10000000000C01
1000000E000001
10010000000001
10010000000001
11111111111111