11111111111111
1P000000000001
10000000000001
10000000000C01
10000000000001
11110000000001
1E010000000001
11111111111111